+---+---+---+---+---+---+---+---+---+---+---+---+---+---+---+---+   +---+---+---+
|                               |       |           |           |       |       |
+   +---+---+---+   +---+---+   +   +   +   +   +---+   +   +---+---+   +---+   +
|       |       |   |   |       |   |   |   |           |           |       |   |
+---+   +   +   +   +   +   +---+---+   +   +---+---+   +---+---+   +---+   +   +
|   |   |   |   |   |   |           |       |       |   |               |   |   |
+   +   +   +   +   +   +---+---+   +   +---+   +   +---+   +---+---+   +   +   +
|       |   |       |       |       |       |   |           |           |       |
+   +---+   +---+---+   +---+   +---+---+---+   +---+---+---+   +---+---+---+   +
|   |   |   |           |       |       |               |           |       |   |
+   +   +   +---+---+   +   +---+   +   +   +   +---+   +---+---+   +   +---+   +
|       |   |       |   |           |       |   |   |           |       |       |
+---+   +   +   +   +   +   +---+---+---+---+   +   +---+---+   +---+---+   +---+
|   |   |       |   |       |           |       |           |       |       |   |
+   +   +---+---+   +---+---+   +---+   +---+---+---+---+   +---+   +   +---+   +
|   |   |   |       |       |       |               |       |       |       |   |
+   +   +   +   +---+   +   +---+   +---+---+   +---+   +---+   +---+---+   +   +
|   |       |   |       |           |       |           |   |           |       |
+   +---+   +---+   +---+---+---+---+   +   +---+---+---+   +---+---+   +---+   +
|                                       |                           |           |
+---+---+---+---+---+---+---+---+---+---+---+---+---+---+---+   +---+---+---+---+