+---+---+---+---+   +---+---+---+---+---+---+---+---+---+---+---+---+---+---+---+
|           |   |   |           |                           |               |   |
+   +   +   +   +   +   +---+   +   +---+---+---+---+---+   +---+   +---+   +   +
|   |   |       |   |   |   |   |       |               |       |   |           |
+   +   +---+---+   +   +   +   +   +   +   +---+---+   +---+   +   +---+---+   +
|   |               |   |       |   |   |           |                   |       |
+   +---+---+---+---+   +   +---+   +   +---+---+   +---+---+---+   +   +---+   +
|   |       |           |       |   |       |   |   |           |   |       |   |
+   +---+   +   +---+   +---+   +---+---+   +   +   +   +   +   +---+---+   +   +
|   |       |       |       |               |   |   |   |   |               |   |
+   +   +---+---+   +---+   +---+---+---+---+   +   +---+   +---+---+---+---+   +
|   |           |   |       |                   |       |   |               |   |
+   +---+---+   +   +   +---+   +---+---+---+---+---+   +   +   +---+---+   +   +
|           |   |   |       |       |       |           |           |       |   |
+---+---+   +   +   +---+   +---+   +   +   +   +---+---+---+---+---+   +---+---+
|           |           |   |       |   |       |                   |           |
+   +---+---+   +---+---+   +   +---+   +---+---+   +---+---+---+   +---+---+   +
|       |       |           |       |   |               |       |       |       |
+---+   +---+---+   +---+---+   +---+   +---+---+---+   +   +   +---+   +   +   +
|                   |           |                       |   |               |   |
+---+---+---+---+---+---+---+---+   +---+---+---+---+---+---+---+---+---+---+---+